

NO ./resource/image/barrel.xpm
SO ./resource/image/bluestone.xpm
WE ./resource/image/colorstone.xpm
EA ./resource/image/eagle.xpm


F 100,100,255
C 100,255,100

        1111111111111111111111111
        1000000000110000000000001  111
        1011000001110000000000001  101 
        1001000000000000000000001  111
111111111011000001110000000000001
100000000011000001110111111111111
11110111111111011100000010001
11110111111111011101010010001
11000000110101011100000010001
10000000000000001100000010001
1000N000000000001101010010001
110000011101010111110111100011111
11110111 1110101 101111010001
11110111 1110111 111111111111
 1111       1

