

NO ./resource/image/barrel.xpm
SO ./resource/image/bluestone.xpm
WE ./resource/image/colorstone.xpm
EA ./resource/image/eagle.xpm


F 255,100,0
C 225,30,1

11111        111
1N001        111
10001        101
10001        111
11111        111

